10111111111111111111111111111111
10100010001000000000001000000011
10101010101011111111101011111011
10101010101000100000101010001011
10101010101110101110101010101111
10001000101000100010001010100011
11111111101011111011111010111011
10000000100010001000001000100011
10111011111110111111101111101011
10001010000010000010100010001011
11101010101010101010111010111011
10101000101010101000001000101011
10101111101011101011111111101011
10100010001000001010000000001011
10101110101111111010111111101011
10101000101000100010100000101011
10101011111010111110101010101011
10001000001010001000101010101011
10111111101011101011111010101011
10100000100010001010000010100011
10101011111110101011101111111111
10101000001000101000100000001011
10101111101011101110111110101011
10101000001010000010000000101011
10111011111010111111111111101011
10100010001010001000001000101011
10101010101011101010101011101011
10101010100010001010100010001011
10101010111111111010111110111011
10001010000000000010000000000011
11111111111111111111111111111101
11111111111111111111111111111101
